%%%%%%%%%%%%%%%%%%%%%
%.                  %
%                   %
%                   %
%                   %
%         P         %
%                   %
%                   %
%                   %
%                   %
%%%%%%%%%%%%%%%%%%%%%