%%%%%%%
%    .%
%     %
%     %
%     %
%P    %
%%%%%%%