%%%%%%%
%    .%
% %%%%%
%     %
%%%% %%
%P    %
%%%%%%%