%%%%%%%%%%%%%%%%%%%%%%%%%%%%%%%%%
%   %   %   %   %   %   %   %   %          
% % % % % % % % % % % % % % % % %
% % % % % % % % % % % % % % % % %
% % % % % % % % % % % % % % % % %
% % % % % % % % % % % % % % % % %
% % % % % % % % % % % % % % % % %
% % % % % % % % % % % % % % % % %
%.%   %   %   %   %   %   %   % %
%%%%%%%%%%%%%%%%%%%%%%%%%%%%%%% %
% P                             %
%%%%%%%%%%%%%%%%%%%%%%%%%%%%%%%%%
