%%%%%%%%%%%%%%%%%%%%%%%%%%%%%%%%%
%   %   %   %   %   %   %   %   %          
% % % % % % % % % % % % % % % % %
% % % % % % % % % % % % % % % % %
% % % % % % % % % % % % % % % % %
% % % % % % % % % % % % % % % % %
% % % % % % % % % % % % % % % % %
% % % % % % % % % % % % % % % % %
%.%   %   %   %   %   %   %   %P%
%%%%%%%%%%%%%%%%%%%%%%%%%%%%%%%%%
